1111111111111111111111111111111111
1E000C0000000011100000010100010001
1110010100100010101001000101010101
1010010010101011101011010001010111
1P0C00C0000000000010001001010000C1
1111111111111111111111111111111111
