11111111111111111111111111111111111111111111111111111111111111111111111111111111111111111111111111
1E000C000000001110000001010001000000000C0000000011100000010100010000000000000000000000000000000111
11100101001000101010010001010101011110010100100010101001000101010100000000000000000000000000000111
10100100101010111010110100010101111010010010101011101011010001010100000000000000000000000000000111
1P0C00C0000000000010001001010000C1100C00C000000000001000100101000110000000000000000000000000000111
10000000000000000000000000000000000000000000000000000000000000000000000000000000000000000000000011
10000000000000000000000000000000000000000000000000000000000000000000000000000000000000000000000111
10000C000000001110000001010001000000000C0000000011100000010100010000000000000000000000000000000111
11100101001000101010010001010101011110010100100010101001000101010100000000000000000000000000000111
10100100101010111010110100010101111010010010101011101011010001010100000001111111111111111111111111
100000C0000000000010001001010000C1100C00C0000000000010001001010001C0000000000000000000000000000001
10000000000000000000000000000000000000000000000000000000000000000001000000000000000000000000000011
10000000000000000000000000000000000000000000000000000000000000000001111111111111111111110000011111
10000C000000001110000001010001000000000C0000000011100000010100010001000000000000000000000000000111
11100101001000101010010001010101011110010100100010101001000101010101000000000000000000000000000001
10100100101010111010110100010101111010010010101011101011010001010101000000000000000000000000000011
100C00C0000000000010001001010000C1100C00C0000000000010001001010001C1000000000000000000000000000001
11111111111111111111111111111111111111111111111111111111111111111111111111111111111111111111111111
