1111111111111
1P0E0C0000001
1111111111110