1111111111111
1P0E0000001C1
1111111111111